NO ./textures/wall_5.xpm
SO ./textures/wall_6.xpm
WE ./textures/wall_7.xpm
EA ./textures/wall_8.xpm
F 220,170,70    # Floor: MGOLD
C 135,206,235   # Floor: sky blue

11111
1N0 1
11111