NO ./textures/3.xpm
SO ./textures/5.xpm
WE ./textures/1.xpm
EA ./textures/4.xpm
F 34,139,34     # Floor: grass green
C 135,206,235   # Floor: sky blue

1111111
1000001
1002001
1000N01
1000001
1111111