1111111111111
1000000010101
10P00C000C0C1
100E000000001
1111111111111