NO ./textures/wall_xpm
SO ./textures/wall_xpm
WE ./textures/wall_xpm
EA ./textures/wall_xpm
F 220,100,0
C 225,30,0
1111111111111
1001000000011
1000000000011
1001P00C00E11
1111111111111
