NO ./textures/wall_5.xpm
SO ./textures/wall_6.xpm
WE ./textures/wall_7.xpm
EA ./textures/wall_8.xpm
F 0, 160, 120  # Floor: ELF bright elf green
C 41,117,119

         11111111111111111111111111111
         10000000001100000000000000001
         10110000011100000001111111111
11111111110000000000000000011111
        101100000111000000000111111
111111111001100000111011111111
11110111111111011100000010001
11110111111111011101010010001
11000000110101011100000010001
10000000000000001D00000010001
10000000010000001100010000001
11000000110101000000000000001
111101D1110101000002200000001
10000000001100000111D11010001
10000000000000000000000001001
10000000111100010000S00001001
100000001  100110101110000001
10000000111110000001 10100001
11111111111111111111 11111111