NO ./textures/wall_5.xpm
SO ./textures/wall_6.xpm
WE ./textures/wall_7.xpm
EA ./textures/wall_8.xpm
F 245,245,250   # Floor: W snowy white
C 225,30,0

1111111111
10001D1001
1000000201
10000N0001
1000000001
1000000001
1111111111