NO ./textures/wall_1.xpm
SO ./textures/wall_2.xpm
WE ./textures/wall_3.xpm
EA ./textures/wall_4.xpm
F 34,139,34
C 135,206,235

1111111
1N000S1
1000001
1000001
1000001
1111111
