NO ./textures/wall_1.xpm
SO ./textures/wall_2.xpm
WE ./textures/wall_3.xpm
EA ./textures/wall_4.xpm
F 10,20,30
C 40,50,60

 11111
 1N001
 10001
 11111
