NO ./textures/wall_5.xpm
SO ./textures/wall_6.xpm
WE ./textures/wall_7.xpm
EA ./textures/wall_8.xpm
F 100,100,100
C 200,200,200

11111
1N0W1
10001
120D1
11111
