NO ./textures/wall_5.xpm
SO ./textures/wall_6.xpm
WE ./textures/wall_7.xpm
EA ./textures/wall_8.xpm
F 100,0,0
C 0,100,0

1111111
100020 
100N001
1111111