NO ./textures/wall_1.xpm
SO ./textures/wall_2.xpm
WE ./textures/wall_3.xpm
EA ./textures/wall_4.xpm
F 5,5,5
C 10,10,10

111111
10011111111
10N001
111111
