NO ./textures/wall_1.xpm
SO ./textures/wall_2.xpm
WE ./textures/wall_3.xpm
EA ./textures/wall_4.xpm
F 1,1,1
C 2,2,2

11111
10N01
110 1
11111
