NO ./textures/wall_5.xpm
SO ./textures/wall_6.xpm
WE ./textures/wall_7.xpm
EA ./textures/wall_8.xpm
F 0,0,0
C 255,255,255

11111
1N001
#######
10001
11111