NO ./a.xpm
SO ./b.xpm
WE ./c.xpm
EA ./d.xpm
F 0,0,0
C 255,255,255

11111
1N001

10001
11111