NO ./textures/3.xpm
SO ./textures/5.xpm
WE ./textures/1.xpm
EA ./textures/4.xpm
F 45,45,45
C 200,255,200

1111111
1000201
1020W01
1000001
1111111
